#                   #
$               ~   $
$               H###$
$     .B        H   $
$    ####   &&  H   $
$ ! B$  $  .    H . $
$###################$